Gg, Gg, Gg, Gg, Hhd, Gg, Re, Gg, Gg, Gg, Gg, Hh, Gg, Gg, Gg, Gg, Gg, Gg, Gg, Gg, Gg, Gg, Gg, Ww, Wo, Wwr, Ss
Gll^Fdf, Gll^Fdf, Gll^Fdf, Hhd, Gs, Gs, Gs, Gs, Gg, Gg, Gg, Gg, Gg^Gvs, Gg, Gg, Gg, Gs, Gs, Gg, Hh, Hh, Gg, Ss, Ww, Wo, Wwr, Ss
Gg, Gll^Fdf, Gg, Gg, Gg^Gvs, Gg^Gvs, Gg, Gg, Gg, Gg, Gs, Gs, Gg^Gvs, Gg^Gvs, Gg, Gg, Gll^Fmf, Gll^Fp, Gg, Gs, Gg, Gg, Wwr, Wo, Wo, Ww, Ww
Gg, Gg, Gd, Gd, Gg^Gvs, Gg^Gvs, Gg, Gg, Gg, Gg, Ch, Gs, Gs, Gg^Gvs, Gg, Gg, Gll^Fmf, Gd, Gg, Gg, Gg, Gg, Rp, Wwr, Wo, Wo, Ww^Bsb/
Rp, Gg, Rp, Gg, Gs, Gg, Gg, Gg, Rp, Rp, Rr^Vhc, 2 Kh, Ch, Gg, Gg, Gg, Rp, Gs^Vh, Rp, Rp, Rp, Gg, Ch, Ww, Wo^Bsb/, Ww^Bsb/, Rp
Gs, Rp, Gg, Rp, Rp, Rp, Rp, Rp, Gg, Rp, Ch, Ch, Ch, Rp, Rp, Rp, Gg, Rp, Gg, Gg, Rp, Rp, Rp, Ww^Bsb/, Wo^Bsb/, Ww^Bsb/, Ch
Gs, Gs, Gg, Gg, Gg, Gg, Gg, Gg, Gg, Gg, Gg, Rp, Gg, Gg, Gg, Gg, Gs, Gs, Gg, Gd, Gd, Gg, Ww^Bsb/, Ww^Bsb/, Wo, Ww, Gg
Gg, Gg, Hh, Gg, Gll^Fmf, Gg, Gg, Gg, Gg, Gg, Gg^Gvs, Gg, Gg, Gg, Gg, Gs, Gg, Gg, Gd, Gd, Gg, Gg, Ww, Wo, Ww, Ww, Gg
Gg, Gs, Gs, Gll^Fmf, Gg, Gll^Fp, Gg, Gg, Gg, Gg^Gvs, Gg^Gvs, Gg^Gvs, Gg, Gs, Gg, Gg, Gg, Gg, Gs, Gd, Gg, Gg, Ww, Wo, Wo, Ww, Wwr
Gg, Gs, Gll^Fmf, Gg, Gg, Gg, Gs, Gs, Gs, Gg, Gg, Gg, Gg, Gg, Gll^Fp, Gg, Gg, Gg, Gs^Vh, Gg, Gg, Ss, Ww, Wo, Ww, Wwr, Ww
Gg, Gg, Gll^Fdf, Gs, Gg, Gs, Gg, Gg, Gg, Gg, Gs, Gg, Gg, Gg, Gg, Gg, Gg, Gg, Gg, Gg, Wwr, Ww, Wo, Wo, Ww, Ww, Ww
Gg, Gll^Fdf, Gg, Gg, Gg, Gg, Gg, Gg, Hh, Gg, Gg, Gs, Gg, Gg, Gg, Hh, Gg, Gg, Gg, Gg, Gg, Ww, Ww, Wo, Wo, Ww, Gg
Gg, Gg, Gg, Gg, Gs^Vh, Gg, Gg, Hh, Gg, Gg, Gg, Gg, Gg, Gg, Gg, Gg, Gg, Gg, Gg, Gs, Gg, Gg, Ww, Ww, Wo, Ww, Wwr
Gg, Gs, Gg, Gg, Gg, Gg, Gg, Gg, Gg, Gg, Gg, Gg, Gg, Gg, Gg, Gg, Gg, Gg, Gg, Gg, Gg, Ss, Ww, Wo, Wo, Ww, Ww
Gg, Gg, Gll^Fp, Gg, Gg, Gs, Gg, Gg, Gg, Gd, Gll^Fp, Gs, Gg, Gg, Gg, Gg, Gg, Gd, Gg, Gg, Gg, Ss, Wwr, Wo, Wo, Ww, Hh
Gg, Gg, Hhd^Fp, Gll^Fp, Gg, Re, Gg, Gg, Gg, Gll^Fp, Gg, Gg, Gg^Gvs, Gg^Gvs, Gg^Gvs, Gg^Gvs, Gg, Gg, Gs, Gg, Gg, Gg, Gg, Ww, Wo, Ww, Wwr
Gg, Gg, Gg, Gll^Fp, Gg, Gg, Gg, Gg, Gg, Gg, Gg, Gg, Gg, Gs^Vh, Gg, Gg, Hh^Fp, Gs, Gg, Gg, Gg, Gg, Gg, Ww, Wo, Wo, Ww
Gg, Gg, Gg, Gg, Gg, Gg, Gs, Gg, Gs, Gg, Gg, Gg, Gg, Gg, Gll^Fmf, Gll^Fp, Gll^Fmf, Gg, Gg, Gg, Gg, Gg, Ww, Ww, Wo, Ww, Ss^Vhs
Gg, Gg, Gs, Gg, Gll^Fdf, Gs, Gg, Gs, Gs, Gg, Gg, Gg, Gg, Gg, Gg, Gg, Gg, Gg, Gg, Gg, Gg, Ww, Ww, Ww, Wo, Ww, Ss
Gg, Gg, Gs^Vh, Gg, Gll^Fdf, Gg, Gg, Gg, Gg, Gg, Gg, Gg, Gg, Gg, Gg, Gg, Gg, Gg, Gg, Gg, Gg, Wwr, Ww, Wo, Ww, Wo, Ww^Ewl
Gg, Gg, Gll^Fdf, Gg, Gg, Gg, Gg, Gg, Gg, Gg, Gd, Gg, Gg, Gg, Gll^Fmf, Gg, Gg, Gg, Gg, Gg, Ww, Ww, Wo, Wo, Wwr, Wwr, Gg
Gg, Gg, Gs, Gs, Gg, Gg, Gg, Gg, Gg, Gg, Gg, Gg, Gg, Gll^Fmf, Gll^Fp, Gg, Gg, Gs^Vh, Gg, Gg, Ww, Wo, Ss, Ss, Gg, Ww, Ww
Gg, Gg, Gg, Gg, Gg, Gg, Gg, Gg, Gg, Gg, Gg, Gg, Gg, Gg, Gg, Gg, Ww, Gg, Ss, Ss, Wo, Wo, Ss, Hh, Gg, Gg, Gll^Fp
Gg, Gg, Gd, Gg, Gg, Gg, Hh, Gg, Gs, Gg, Gg, Gg, Wwr, Wwr, Ww, Ww, Wo, Ww, Wo, Wo, Wo, Ww, Gg, Gg, Gg, Gg, Gs
Gg, Gg, Re, Gg, Gg, Gg, Hh, Gs, Gs, Gs, Gg, Gg, Ss, Ww, Wo, Wo, Ww, Wo, Ww, Wo, Ww, Ww, Gg, Gg, Gg, Gs, Gs
Gg, Gg, Gg, Gg, Gs^Vh, Gg, Gg, Hh, Gg, Gd, Re, Ss, Ww, Wo, Ww, Ww, Gg, Wwr, Gg, Wwr, Gg, Gg, Gg, Gll^Fmf, Gll^Fmf, Gg, Gg
Gg, Gg, Gll^Fp, Gg, Gd, Gg, Gg, Gg, Gg, Gg, Wwr, Ww^Bw\, Wo^Bw\, Wo, Ww, Gg, Gg, Gg, Gll^Fdf, Gg, Gs, Gg, Gs, Gg, Gs^Vh, Gg, Gg
Gs, 1 Gg, Hh^Fp, Gll^Fp, Gg, Gd, Gg, Gg, Gg, Gg, Ss, Wo, Wo, Ww^Bw\, Ww^Bw\, Gg, Gs, Gll^Fdf, Gg, Gll^Fmf, Gg, Gs, Gg, Gg, Gg, Gd, Gg
Gg, Gs, Gg, Gs, Gg, Gg, Gg, Gg, Wo, Gg, Ww, Wo, Wo, Wo, Gg, Re, Gg, Gs, Gg, Gg, Gg, Gg, Gg, Gg, Gg, Gg, Gg
