Xu, Uu, Ur, Xu, Xu, Xu, Xu, Xu, Ur, Xu, Xu, Xu, Uu, Xue, Xue, Xue, Xue, Xu, Uu, Xu, Xu, Xu, Xu, Xu, Xu, Xu, Xu, Xu, Xu, Xu, Xu, Xu, Xu, Xu, Xu, Xu, Xu, Xu, Xu, Xu, Xu, Ss, Ss, Wwg, Wwf, Wwg, Xu, Xu, Xu, Xu
Xu, Xu, Uu, Ur, Uu, Xu, Xu, Xu, Uu, 6 Uu, Uu, Xu, Ur, Uue, Ur, Xue, Uue, Uu, Uu, Xu, Uu^Tf, Xu, Xu, Xu, Uh, Uh, Uu, Xu, Xu, Xu, Xu, Xu, Xu, Xu, Xue, Xue, Xue, Xu, Xue, Xue, Xu, Ss^Vhs, Wwg, Wwg, Cme, Uh, Xu, Xu, Xu, Xu
Xu, Uu, Uu, Uu, Ur, Uu, Uh, Xu, Ur, Uu, Uu, Ur, Uu, Ur, Uue, Uhe, Qxe, Ur, Ur, Uh, Uu, Ur, Ur, Xu, Ur, Uh, Uu, Xu, Xu, Xu, Xu, Xu, Ss, Xue, Uhe, Uue^Tf, Xue, Xue, Uue, Uhe, Ss, Wwg, Xu, Wwg, Cme, Xu, Xu, Xu, Xu, Xu
Qxu, Uh^Tf, Uu, Uu, Qxu, Ur, Uu, Uh, Uh, Uu, Uu, Uu, Xu, Uu, Xu, Uh, Uu, Qxu, Uu, Uu, Uu, Uu, Uu, Uu, Ur, Uu, Uh, Uu, Uu, Xu, Xu, Xu, Ss, Wwf^Ewl, Wwf, Ds, Wwf, Xue, Sm, Wwrg, Ww^Vm, Xu, Wwrg, Ww^Vm, 7 Cme^Kyn, Xu, Uh, Xu, Uh, Xu
Qxu, Qxu, Qxu, Qxu, Xu, Uu, Uu, Uh, Xu, Uu, Xu, Xu, Uu, Xu, Xu, Xu, Xu, Uu, Xu, Uh, Xu, Uh, Uh, Uh, Uu, Ur, Uu, Uu, Uu, Xu, Ds, Uh, Wwg, Xu, Wwg, Wwrg, Sm, Wwg, Wwg, Wwg, Wwg, Wwg, Wwf, Cme, Cme, Wwf, Wwf, Uu, Wwg, Wwg
Qxe, Qxu, Qxe, Xu, Uu, Ur, Xu, Uu, Uh, Ur, Uu, Uu, Uu, Uu, Uu, Xu, Uh, Xu, Xu, Xu, Xu, Xu, Xu, Uh, Xu, Uu, Uu, Ur, Uu, Ds, Wwg, Wwg, Wwg, Xu, Wwg, Sm, Xu, Uue, Sm, Wwg, Wwg, Wwf, Uu^Tf, Xu, Xu, Cme, Ss, Ss^Vhs, Xu, Ds
Xue, Qxe, Xue, Xu, Uh, Xu, Xu, Uh^Tf, Uh, Ur, Uu, Uh, Uu, Ur, Ur, Uh, Uu, Xu, Xu, Xu, Xu, Xu, Xu, Xu, Xu, Xu, Ds, Ds, Ds, Ds, Wwf, Wwg, Wwf, Wwg, Wwrg, Xu, Xu, Uh, Sm, Wwg, Ss, Ss^Vhs, Xu, Uh, Xu, Xu, Xuc, Xu, Xu, Xu
Xue, Xue, Uue, Xu, Ur, Uh, Uu, Xu, Xu, Uu, Xu, Uu, Uu, Ur, Qxu, Uu, Uu, Uu, Uh, Xu, Wwrg, Xu, Wwrg, Xu, Xu, Ds, Wwg, Wwrg, Wwg, Wwf, Wwf, Wwf, Ds, Wwrg, Uh, Wwrg, Wwg, Sm, Wwg, Wwg, Ss, Xu, Xu, Xu, Uh, Xu, Xu, Xu, Xu, Xu
Xue, Uue, Uu, Ur, Xu, Xu, Uu, Xu, Xu, Xu, Uu, Uu, Uh, Qxu, Qxu, Uh, Uu, Ur, Ds, Wwf, Wwf, Wwrg, Wwf, Wwg, Wog, Wwg, Wwg, Wwg, Wwg, Wwg, Wwf, Wwf, Ds, Uh, Xu, Ds, Wwg, Wwg, Ss, Xu, Xu, Xu, Xu, Xu, Uh, Xu, Xu, Xu, Xu, Xu
Xu, Xu, Xu, Uu, Xu, Xu, Uu, Xu, Uu, Uh, Xu, Xu, Uu^Tf, Uu, Uu, Uh, Xu, Ds, Wwf, Wwf, Wwf, Wwf, Ds, Ds, Uhe, Wwrg, Wwrg, Wwg, Wwg, Wwf, Cud, Wwf, Cud, Xu^Efs, Xu, Wwrg, Wwg, Wwg, Xu, Xu, Xu, Xu, Xu, Xu, Uu, Xu, Xu, Xu, Xu, Xu
Wog, Xu, Wwrg, Ds, Wog, Uu, Wwg, Wwrg, Wog, Wwrg, Wog, Xu, Xu, Uu, Xu, Xu, Wwrg, Wwrg, Wwg, Wwg, Wwf, Ds, Xue, Uue, Ur^Es, Uh, Ds, Wwg^Ewl, Cud, Xoa^Efs, Ur^Vud, Cud, Ur, Uu^Vud, Xu, Xu, Cud, Cud, Ur^Vud, Xu^Efs, Uu, Xu, Xu, Xu, Uu, Xu, Xu, Xu, Xu, Xu
Wwg, Wog, Wwg, Wog, Ds, Wwg, Xu, Wog, Xu, Xu, Xu, Wog, Wog, Ds, Xue, Xu, Wog, Wwg, Xu, Wwf^Ewl, Xue, Xue, Uhe, Uue, Uu, Ur^Es, Uu, Ds, Cud, Ur^Vud, Ur, Ur, Ur, Xu, Xu^Efs, Ur^Vud, Ur, Ur, Ur, Ur, Xoa^Efs, Xu, Xu, Uh, Xu, Xu, Xu, Xu, Xu, Xu
Ur, 5 Uu, Ur, Ds, Xu, Ds, Uu, Xu, Uue, Xue, Xue, Xue, Xue, Wwg, Wog, Wog, Xu, Wwrg, Xu, Xu, Uu, Uhe^Tf, Uu, Uh, Uu, Uu, Xoa^Efs, Cud, Ur, Ur, Ur, Ur, Cud, Xu, Uu, Ur, Cud, Xoa^Efs, Cud, Cud, Ur^Vud, Xoa, Xoa, Xu, Xu, Xu, Xu, Xu, Xu, Xu
Xu, Xu, Xu, Ur, Xu, Xu, Uh, Uh, Xue, Uue, Uue, Xue, Uue, Ds, Xu, Xu, Xu, Xu, Xu, Xu, Uh, Uu, Uu, Xu, Uu, Uu, Cud, Ur^Vud, Ur, Ur, Cud, Cud, Ur, Xu, Xu, Xu, Ur^Vud, Ur^Vud, Ur, Ur, Ur, Xoa^Efs, Ur, Uu^Vud, Xoa, Xu, Xu, Xu, Xu, Xu
Xu, Xu, Uh, Uu, Ur, Xu, Uu, Xu, Xu, Xue, Xue, Uue, Uhe^Tf, Xue, Xu, Xu, Xu, Xu, Uh, Uu, Uu, Uu, Uu, Xu, Xu, Uu, Cud, Ur, Ur, Ur, Xoa^Efs, Ur^Vud, Ur^Vud, Ur, Cud, Xu^Efs, Ur, Ur, Ur, Ur, Xoa^Efs, Ur, Cud, Ur^Vud, Ur^Vud, Xoa, Xoa, Xu, Xuc, Xuc
Xu, Xu, Uh, Uu, Uu, Ur, Xu, Ur, Xu, Xu, Uue, Uue, Uh, Uh, Uu, Uu, Ur, Uu, Ur, Ur^Es, Uu, Ur^Es, Uu, Xu, Xu, Cud, Ur^Vud, Ur, Ur, Cud, Ur^Vud, Ur, Ur, Ur, Cud, Ur, Ur^Vud, Ur, Cud, Ur^Vud, Cud, Cud^Vud, Xoa^Efs, Cud, Cud, Cud, Xoa, Xuc, Uu, Xuc
Xu, Uh, Xu, Uu, Xu, Xu, Uu, Ur, Uu, Uu, Uue, Uue, Xu, Uu, Uu, Ur, Uu, Uu, Qxu, Qxu, Qxu, Uu, Uh, Uu, Uu, Xu^Efs, Ur^Vud, Ur^Vud, Ur, Cud, Ur, Ur, Ur^Vud, Ur, Cud, Ur, Ur^Vud, Ur, Xoa^Efs, Cud, Ur^Vud, Ur^Vud, Ur^Vud, Ur^Vud, Ur^Vud, Xuc^Efs, Xuc, Uu, Xuc, Uh
Xu, Xu, Xu, Uu, Uu, Xu, Uu, Uu, Uu, Uu, Ur, Xue, Xu, Xu, Uu, Uu, Qxu, Qxu, Qxu, Uu^Tf, Uu, Uh, Uu, Uu, Uu, Cud, Cud, Ur, Xu, Xu, Xu, Ur, Ur, Ur, Cud^Efs, Ur, Ur, Ur, Ur^Vud, Cud, Cud^Vud, Ur^Vud, Ur^Vud, 4 Kud, Cud, Cud, Xuc, Xuc, Xuc, Xuc
Xu, Xu, Xu, Xu, Uu, Xu, Xu, Uu, Qxu, Uu, Uu, Ur, Uu, Uu, Uu, Qxu, Uu, Qxu, Uu, Uh, Xu, Uu, Uue, Uu, Uu, Uu, Cud, Ur, Ur, Xu, Xu^Efs, Ur^Vud, Ur^Vud, Ur, Uu^Vud, Ur, Ur^Br/, Ur^Br\, Ur^Br\, Cud, Ur^Br|, Cud, Cud, Cud^Vud, Cud, Ur^Vud, Xoa, Xuc, Xuc, Xuc
Xu, Xu, Xu, Xu, Uu, Uu, Qxu, Qxu, Uu, Uu, Xu, Uu, Uh, Uu, Qxu^Bcx\, Qxu^Bcx\, Ur, Uu, Uu, Uue, Xue, Xue, Uue, Uue, Uh, Xu, Xu, Ur^Vud, Ur, Ur, Ur, Cud, Cud, Xoa^Efs, Cud, Ur^Br/, Cud, Uu^Vud, Xu, Ur^Br/, Ur^Vud, Xoa^Efs, Cud, Ur^Vud, Cud, Ur^Vud, Xoa, Xuc, Xuc, Xuc
Xu, Xu, Xu, Uu, Uhe, Uue, Qxe, Uu, Xu, Uh, Uu, Xu, Qxu, Uh, Qxu, Uu, Xu, Uh, Uh, Uue, Uue, Uue, Uue, Uue, Uu, Uh, Xu, Xu^Efs, Cud, Ur, Ur, Ur, Ur, Ur, Ur, Ur^Br|, Ur, Xu^Efs, Cud, Ur, Ur, Ur, Ur, Ur^Vud, Ur, Xoa^Efs, Xu, Xuc, Xuc, Xuc
Xu, Uh, Uh, Uhe, Qxe, Uue, Uue, Uue, Qxe, Uu, Qxu, Qxu, Xu, Qxu, Qxu, Uu, Xu, Xu, Xue, Uh, Uu, Qxe, Uu, Uu, Ur^Es, Uu, Uu, Uu, Cud, Ur^Vud, Xu^Efs, Ur, Ur^Vud, Ur, Ur, Ur^Br|, Ur, Ur, Ur, Cud, Xu, Ur, Xoa^Efs, Ur, Xoa, Uu, Xu, Xuc, Xuc, Xuc
Xu, Xu, Uh, Uh^Tf, Qxe, Uue, Xue, Xue, Qxe, Qxu, Xu, Qxu, Uh, Xu, Uu, Uu, Uu, Xue, Uhe, Uhe, Qxe, Qxu, Uu, Ur^Es, Uh, Uu, Uu, Uu, Xu, Xu, Cud, Cud, Cud, Ur^Vud, Cud, Ur^Br|, Cud, Ur^Vud, Xu, Ur, Xu, Ur^Vud, Ur, Ur, Xu, Xu, Xuc, Xuc, Xuc, Xuc
Xu, Xu, Uh, Qxu, Uue, Uue, Qxe, Qxe, Xu, Uu, Uu, Xu, Uh, Uh, Xu, Xu, Xue, Uhe, Qxe, Qxe, Uue^Tf, Uue, Uu, Ur^Es, Uu, Uu, Uu, Xu, Xu, Xu, Uu, Uu, Qxu, Qxu, Qxu, Uu^Br|, Uu^Br\, Xu^Efs, Xuc, Xu, Xu, Ur, Xu, Xu, Xuc, Xu, Xuc, Xuc, Xuc, Xuc
Qxu, Qxu, Xu, Uu, Uu, Uue, Qxu, Uu, Xu, Xu, Xu, Uu, Xu, Xu, Xu, Xu, Xue, Xue, Qxe, Qxe, Qxe, Uue, Ur^Es, Uu, Uh, Uh, Xu, Xu, Xuc, Uue^Dr, Uue, Uu, Uu^Dr, Qxu, Uu, Uu^Dr, Uu, Uu^Dr, Uu^Dr, Xuc, Xuc, Xu, Xuc, Xuc, Uh, Xuc, Xuc, Xuc, Xuc, Xuc
Xu, Xu, Qxu, Qxu, Uu, Uu, Uh, Uu, Xu, Xu, Xu, Xu, Xu, Xu, Xu, Xu, Xu, Qxu, Uh, Uhe, Uhe, Uue, Ur, Uh, Xu, Xu, Xuc, Xuc, Xuc, Uue, Xuc, Uu^Dr, Qxu, Uu, Qxu, Xuc, Xuc, Uu, Xuc^Efs, Uu^Br\, Xuc, Xuc, Xuc, Uue^Dr, Xuc, Xuc, Xuc, Xuc, Xuc, Xuc
Qxu, Qxu, Qxu, Qxu, Uu, Xu, Uh, Uu, Uu, Qxu, Qxu, Qxu, Xu, Xu, Uu, Xu, Qxu, Qxu, Uu, Uu, Ur, Uue, Uu, Xu, Xu, Xuc, Uh, Xuc, Uue^Tf, Uue^Tf, Xuc, Uu^Dr, Qxe, Qxe, Uu^Dr, Uh, Xuc, Uu, Uu^Tf, Uu^Br|, Xuc^Efs, Uue^Dr, Uue^Br/, Uue^Dr, Xuc^Efs, Uhe, Xuc, Xuc, Xuc, Xuc
Xue, Xu, Xu, Xu, Xu, Uu, Uu, Qxu, Uue, Uu, Xu, Xu, Xu, Xu, Xu, Uu, Uu, Uu, Uu, Ur, Uu, Uu, Xu, Xu, Xu, Xuc, Xuc, Uh, Xuc, Xuc, Uu^Dr, Xuc, Xuc, Uue, Xuc, Xuc, Uue^Dr, Xuc, Uu, Uu^Dr, Uu^Br\, Uue^Br/, Xuc, Uue^Br\, Uue^Dr, Uue^Dr, Xuc, Xuc^Efs, Uue^Br\, Xuc
Qxe, Xue, Qxu, Qxu, Qxu, Qxu, Uu, Qxe, Uhe, Xue, Xue, Uu, Uu, Xu, Xu, Xu, Uh, Uh, Ur, Uu, Uu, Uu, Uue, Uu, Xu, Xuc, Xuc, Uu, Xuc, Uu, Xuc, Xuc, Uue, Uue, Uue, Uue^Dr, Uue, Xuc, Uu, Xuc, Xuc, Xuc, Xuc, Xuc, Xuc, Uue^Br\, Uue^Dr, Uue^Br/, Xuc, Uue^Br\
Xue, Qxe, Xu, Uh, Uh, Xu, Xu, Uh, Uue, Xue, Xue, Xue, Xu, Uu, Uh, Uu, Uu, Uh, Ur, Uue, Xue, Xue, Xue, Xue, Xuc, Xuc, Uu, Uu^Dr, Uu, Uu^Dr, Xuc, Xuc, Uu^Dr, Xuc, Uue, Xuc, Xuc, Xuc, Uu^Dr, Xuc, Uu^Tf, Uu, Xuc, Uue^Dr, Xuc, Uue^Tf, Xuc, Uue, Xuc, Xuc
Xue, Xue, Xue, Uu, Uu, Xu, Ur, Uu, Uue, Xue, Uue, Uue, Ur, Uh, Uu, Ur, Uu, Ur, Uu, Uue, Uhe, Uhe, Xue, Xuc, Uue^Tf, Uh, Xuc, Uu, Xuc, Uu, Uu, Uu^Tf, Uu, Xuc, Xuc, Uue, Xuc, Uu, Xuc, Uu, Uu^Dr, Xuc, Uue^Tf, Uue, Uue^Dr, Xuc, Xuc, Uue, Uue^Tf, Xuc
Uue, Uhe, Uu, Uh, Uu, Uu, Uu, Uu, Ur, Ur, Uue, Uue, Uu, Ur, Uh, Uu, Uu, Uu, Uu, Uh, Uhe, Xue, Xu, Xuc, Uue, Xuc, Xuc, Uu, Xuc, Xuc, Xuc, Uh, Uu, Uu, Uu, Uue, Uh, Uu, Uu, Xuc, Xuc, Uue, Xuc, Xuc, Xuc, Uue^Dr, Xuc, Xuc, Uue^Tf, Xuc
Uue, Uue, Ur, Uu, Ur, Ur, Uu, Ur, Uh, Uh, Uu, Uu, Xu, Uu, Uh^Tf, Uu, Uu, Xu, Xu, Uu, Uue, Xue, Xuc, Xuc, Uue^Tf, Xuc, Uu^Tf, Uu, Uu, Uh, Xuc, Uu^Dr, Qxu, Qxu, Qxu, Uh, Xuc, Xuc, Uu^Tf, Xuc, Uue, Uue^Dr, Uue, Uue, Uu, Xuc, Uue, Uue^Tf, Uue, Xuc
Uue, 1 Ur, 2 Uue, Uu, Uh, Xu, Xu, Xu, Xu, Uu, Xu, Xu, Xu, Xu, Xu, Xu, Uh, Xu, Uh, Uh, Xu, Xu, Xuc, Uu^Dr, Xuc, Xuc, Uu, Xuc, Uh, Uu^Dr, Xuc, Uu, Qxu, Qxu^Bh, Qxu, Uu^Dr, Uu, Xuc, Uu^Dr, Uu^Dr, Uue, Xuc, Xuc, Xuc, Uu^Dr, Uue^Tf, Uue, Xuc, Xuc, Uue
Ur, Ur, Uu, Uh, Uh, Uh, Xu, Xu, Xu, Xu, Xu, Xu, Xu, Xu, Xu, Xu, Xu, Xu, Xu, Xu, Xu, Xuc, Uu, Uu^Dr, Xuc, Xuc, Uu, Xuc, Xuc, Xuc, Xuc, Uu, Qxu, Qxu, Qxu, Qxu, Uu^Dr, Xuc, Xuc, Xuc, Xuc, Uue, Xuc, Xuc, Uu, Xuc, Xuc, Uu, Xuc, Xuc
Gg, Uu, Uu, Uu, Xu, Xu, Xu, Xu, Xu, Xu, Xu, Xu, Xu, Xu, Xu, Xu, Xu, Xu, Xu, Xu, Xu, Xuc, Uh, Xuc, Uu^Dr, Uu^Dr, Xuc, Uh, Uh, Xuc, Xuc, Uu, Xuc, Qxu, Qxu, Qxu, Xuc, Uu^Dr, Xuc, Xuc, Xuc, Uue^Tf, Uu, Uu, Xuc, Uu^Dr, Xuc, Uu^Dr, Uu, Xuc
