Chr, Chr, Chr, Chr, Chr, Chr, Chr, Chr, Chr, Chr, Chr, Chr, Chr, Chr, Chr, Chr, Chr, Chr, Chr, Chr, Chr, Chr, Chr, Chr, Chr, Chr
Chr, Chr, Chr, Chr, Chr, Chr, Chr, Chr, Chr, Chr, Chr, Chr, Chr, Chr, Chr, Chr, Chr, Chr, Chr, Chr, Chr, Chr, Chr, Chr, Chr, Chr
Chr, Chr, Chr, Chr, Chr, Chr, Chr, Chr, Chr, Chr, Chr, Chr, Chr, Chr, Chr, Chr, Chr, Chr, Chr, Chr, Chr, Chr, Chr, Chr, Chr, Chr
Khr, Chr, Khr, Chr, Khr, Chr, Khr, Chr, Khr, Chr, Khr, Chr, Khr, Chr, Khr, Chr, Khr, Chr, Khr, Chr, Khr, Chr, Khr, Chr, Khr, Chr
Khr, Khr, Khr, Khr, Khr, Khr, Khr, Khr, Khr, Khr, Khr, Khr, Khr, Khr, Khr, Khr, Khr, Khr, Khr, Khr, Khr, Khr, Khr, Khr, Khr, Khr
Khr, Khr, Khr, Khr, Khr, Khr, Khr, Khr, Khr, Khr, Khr, Khr, Khr, Khr, Khr, Khr, Khr, Khr, Khr, Khr, Khr, Khr, Khr, Khr, Khr, Khr
Khr, Khr, Khr, Khr, Khr, Khr, Khr, Khr, Khr, Khr, Khr, Khr, Khr, Khr, Khr, Khr, Khr, Khr, Khr, Khr, Khr, Khr, Khr, Khr, Khr, Khr
Khr, Khr, Rp^Vhcr, Khr, Rp^Vhcr, Khr, Khr, Khr, Khr, Khr, Rp^Vhcr, Khr, Khr, Khr, Rp^Vhcr, Khr, Rp^Vhcr, Khr, Rp^Vhcr, Khr, Rp^Vhcr, Khr, Rp^Vhcr, Khr, Rp^Vhcr, Khr
Rp^Vhcr, Rp^Vhcr, Rp^Vhcr, Rp^Vhcr, Rp^Vhcr, Rp^Vhcr, Rp^Vhcr, Rp^Vhcr, Rp^Vhcr, Rp^Vhcr, Rp^Vhcr, Rp^Vhcr, Rp^Vhcr, Rp^Vhcr, Rp^Vhcr, Rp^Vhcr, Rp^Vhcr, Rp^Vhcr, Rp^Vhcr, Rp^Vhcr, Rp^Vhcr, Rp^Vhcr, Rp^Vhcr, Rp^Vhcr, Rp^Vhcr, Rp^Vhcr
Rp^Vhcr, Rp^Vhcr, Rp^Vhcr, Rp^Vhcr, Rp^Vhcr, Rp^Vhcr, Rp^Vhcr, Rp^Vhcr, Rp^Vhcr, Rp^Vhcr, Rp^Vhcr, Rp^Vhcr, Rp^Vhcr, Rp^Vhcr, Rp^Vhcr, Rp^Vhcr, Rp^Vhcr, Rp^Vhcr, Rp^Vhcr, Rp^Vhcr, Rp^Vhcr, Rp^Vhcr, Rp^Vhcr, Rp^Vhcr, Rp^Vhcr, Rp^Vhcr
Rp^Vhcr, Rp^Vhcr, Rp^Vhcr, Rp^Vhcr, Rp^Vhcr, Rp^Vhcr, Rp^Vhcr, Rp^Vhcr, Rp^Vhcr, Rp^Vhcr, Rp^Vhcr, Rp^Vhcr, Rp^Vhcr, Rp^Vhcr, Rp^Vhcr, Rp^Vhcr, Rp^Vhcr, Rp^Vhcr, Rp^Vhcr, Rp^Vhcr, Rp^Vhcr, Rp^Vhcr, Rp^Vhcr, Rp^Vhcr, Rp^Vhcr, Rp^Vhcr
Rp^Vhcr, Rp^Vhcr, Rp^Vhcr, Rp^Vhcr, Rp^Vhcr, Rp^Vhcr, Rp^Vhcr, Rp^Vhcr, Rp^Vhcr, Rp^Vhcr, Rp^Vhcr, Rp^Vhcr, Rp^Vhcr, Rp^Vhcr, Rp^Vhcr, Rp^Vhcr, Rp^Vhcr, Rp^Vhcr, Rp^Vhcr, Rp^Vhcr, Rp^Vhcr, Rp^Vhcr, Rp^Vhcr, Rp^Vhcr, Rp^Vhcr, Rp^Vhcr
